alameda|alam
angosta|angta
autopista|auto
autovia|autov
avenida|av|ave|avd|avda|avinguda
bulevar|bulev
calle|c|cl
caminohondo|ch
caminonuevo|cn
callecilla|callecillas
callecita|callecitas
callezona|callezonas
callezota|callezotas
circunvalacion|ccvcn
carreterainterestatal|cint
calleja|cjla|cllja
callejon|cjon|cllon
callizo|cllzo
calliza|cllza
camino|cmno
carrero|cro
carrera|cra|cr|crr
carrer|cro
Carril|crril
carretera|ctra
Carreterín|ctrin
calzada|czada
diagonal|diag
errepidea|err
etorbidea|etorb
granvía|gv
glorieta|gta
passatge|pasaje|psaje
passatge|ptge|passeig|pg
placa|pl
plaza|plza|pza
puente|pnte
puerto|pto
rambla|rbla
sendaera|sedra|send|sendera
rambla|rbla
transito|trans
transversal|trval
tranvia|trva
